10
10
0001010000
1000001000
0000100000
0010000000
0000000001
0010000000
0000000001
0000100000
0000100000
0001000000