15
10
000000001000000
000100000010000
001000000000000
000000000000100
000000100000000
000000000100000
000010000000000
000000010000000
001000000000000
000000000010000
